R 1920 1080

NO ./../texture/redbrick.xpm
SO ./../texture/colorstone.xpm
WE ./../texture/bluestone.xpm
EA ./../texture/eagle.xpm

S ./../texture/barrel.xpm
C 130,226,255
F 130,255,110

        1111111111111111111111111        1111111111111111111111111
        1000000000110000000000001        1000000000110000000000001
        1011000001110000002000001        1011000001110000002000001
        1001000000000000000000001        1001000000000000000000001
111111111011000001110000000000001111111111011000001110000000000001
100000000011000001110111111111111100000000011000001110111111111111
1111011111111101110000001000111110111111111011100000010001
11110111111111011101010010001111101111 1 11011101010010001
1100000011010101110000001000111000000110101011100000010001
1000200000000000000000000000110002000000000000000000000001
1000000000000000110101001000000000000000000001101010010001
11000001110101011111011110N011111000001110101011111011110111
1111011111110101110111101000111110111111101011101111010001
111111111111111111111111110111111111111111111111111111111
        111111111111111111011111        1111111111111111111111111
        1000000000110000000000001        1000000000110000000000001
        1011000001110000002000001        1011000001110000002000001
        1001000000000000000000001        1001000000000000000000001
111111111011000001110000000000001111111111011000001110000000000001
100000000011000001110111111111111100000000011000001110111111111111
1111011111111101110000001000111110111111111011100000010001
1111011111111101110101001000111110111111111011101010010001
1100000011010101110000001000111000000110101011100000010001
1000200000000000000000000000000002000000000000000000000001
1000000000000000110101001000110000000000000001101010010001
110000011101010111110111101011111000001110101011111011110111
11110111 1110101 10111101000111110111111101011101111010001
11111111 1111111 11111111111111111111 1111111 111111111111