R 500 500
NO ./texture/redbrick.xpm
SO ./texture/eagle.xpm
WE ./texture/colorstone.xpm
EA ./texture/bluestone.xpm
S ./texture/barrel.xpm
C 100,100,255
F 255,255,110

11111111111111
12000000000021
10002111120001
10021    12001
1001      1001
10021    12001
10002111120001
1200000000000111111111111111111111111111111111111
111111111111E000000000000000000000000000000000001
1111111111111111111111111111111111111111111111111