R 500 500

NO ./../texture/redbrick.xpm
SO ./../texture/colorstone.xpm
WE ./../texture/bluestone.xpm
EA ./../texture/eagle.xpm

S ./../texture/barrel.xpm
C 130,226,0
F 255,255,110

1111111111
1000001001
1000110001
101120011
1000000101
1000000001
1001110001
1011N11001
1000001001
1111100001
1111111111