R 500 500

NO ./../texture/apex_1.xpm
SO ./../texture/apex_1.xpm
WE ./../texture/apex_1.xpm
EA ./../texture/apex_1.xpm
S ./../texture/barrel.xpm
C 100,100,255
F 255,255,110

 111111 
10000001
10000001
10000001
10111101
10000001
100N0001
 111111