R 1000 1000

NO ./../texture/redbrick.xpm
SO ./../texture/colorstone.xpm
WE ./../texture/bluestone.xpm
EA ./../texture/eagle.xpm

S ./../texture/barrel.xpm
C 130,226,0
F 255,255,110

11111111111111111111111111111111111
10000000000000000000000000000000001
1111111111111110000000000000000011
1000000000000000000111111100000011
100001111011000N000000000011100011
1000000000110000000000001111110011
1000000000110000000000000000000011
1000000000110000001111111111110011
10000000000000000000000000000000001
11111111111111111111111111111111111