R 800 400

NO ./../texture/redbrick.xpm
SO ./../texture/colorstone.xpm
WE ./../texture/bluestone.xpm
EA ./../texture/eagle.xpm

S ./../texture/barrel.xpm
C 130,226,255
F 130,255,110

111111111
1S000001
100000001
100000001
111111111