R 1000 1000

NO ./../texture/redbrick.xpm
SO ./../texture/colorstone.xpm
WE ./../texture/bluestone.xpm
EA ./../texture/eagle.xpm

S ./../texture/barrel.xpm
C 130,226,0
F 255,255,110

1111111111
1000000001
1020202021
1010101011
1020202021
1021202121
1021202121
1020202021
1000000001
10000N0001
1111111111