R 500 500
NO ./texture/redbrick.xpm
SO ./texture/bluestone.xpm
WE ./texture/colorstone.xpm
EA ./texture/eagle.xpm
S  ./texture/barrel.xpm

C 100,100,255
F 255,255,110

1111111111111
1000000000001
1211001000001
1100001000001
1000001000221
1E01111102001
1111111111111