R 500 500
NO ./texture/redbrick.xpm
SO ./texture/eagle.xpm
WE ./texture/colorstone.xpm
EA ./texture/bluestone.xpm
S ./texture/barrel.xpm
C 100,100,255
F 255,255,110

1111111111
1020000121
1000000101
1001110101
1111200001
1000N00001
1111111111