R 100000 1000000
NO ./texture/redbrick.xpm
SO ./texture/bluestone.xpm
WE ./texture/colorstone.xpm
EA ./texture/eagle.xpm
S  ./texture/barrel.xpm

C 100,100,255
F 255,255,110

1111111111111
1111111111111
1100000000011
11000E0200011
1100000000011
1111111111111
1111111111111